AAA= "countries/AAA.txt"
IUI= "countries/IUI.txt"
DRM= "countries/DRM.txt"
USR= "countries/USR.txt"
GUG= "countries/GUG.txt"
PKT= "countries/PKT.txt"
FRW= "countries/FRW.txt"
BHL= "countries/BHL.txt"
RSH= "countries/RSH.txt"
ITE= "countries/ITE.txt"
LYH= "countries/LYH.txt"
DDE= "countries/DDE.txt"
SKS= "countries/SKS.txt"
HUS= "countries/HUS.txt"
NNN= "countries/NNN.txt"
FER= "countries/FER.txt"
SHH= "countries/SHH.txt"
CPC= "countries/CPC.txt"
UBS= "countries/UBS.txt"
MXG= "countries/MXG.txt"
BRA= "countries/BRA.txt"
SHW= "countries/SHW.txt"
SBY= "countries/SBY.txt"
WWS= "countries/WWS.txt"
ENL= "countries/ENL.txt"
ZHX= "countries/ZHX.txt"
FTX= "countries/FTX.txt"
MEG= "countries/MEG.txt"
WUP= "countries/WUP.txt"
SUC= "countries/SUC.txt"
HAQ= "countries/HAQ.txt"
ROC= "countries/ROC.txt"
MZY= "countries/MZY.txt"
DTJ= "countries/DTJ.txt"
XJC= "countries/XJC.txt"
NXS= "countries/NXS.txt"
XZZ= "countries/XZZ.txt"
CEX= "countries/CEX.txt"
SCX= "countries/SCX.txt"
GUI= "countries/GUI.txt"
FEL= "countries/FEL.txt"
QIX= "countries/QIX.txt"
IRL= "countries/IRL.txt"
KON= "countries/KON.txt"
JPN= "countries/JPN.txt"
ESI= "countries/ESI.txt"
VAN= "countries/VAN.txt"
LWO= "countries/LWO.txt"
CNA= "countries/CNA.txt"
AOX= "countries/AOX.txt"
HES= "countries/HES.txt"
AGN= "countries/AGN.txt"
TEQ= "countries/TEQ.txt"
YED= "countries/YED.txt"
XIL= "countries/XIL.txt"
LMJ= "countries/LMJ.txt"
EYJ= "countries/EYJ.txt"
SIW= "countries/SIW.txt"
ALB= "countries/ALB.txt"
LXS= "countries/LXS.txt"
YZM= "countries/YZM.txt"
YDA= "countries/YDA.txt"
DSX= "countries/DSX.txt"
DSN= "countries/DSN.txt"
LMN= "countries/LMN.txt"
BOJ= "countries/BOJ.txt"
NUW= "countries/NUW.txt"
RUD= "countries/RUD.txt"
PTY= "countries/PTY.txt"
AFH= "countries/AFH.txt"
GUB= "countries/GUB.txt"
ARG= "countries/ARG.txt"
YEL= "countries/YEL.txt"
NZS= "countries/NZS.txt"
BUD= "countries/BUD.txt"
NBE= "countries/NBE.txt"
DMW= "countries/DMW.txt"
ASZ= "countries/ASZ.txt"
YDN= "countries/YDN.txt"
WLG= "countries/WLG.txt"
YNG= "countries/YNG.txt"
CHE= "countries/CHE.txt"
XXL= "countries/XXL.txt"
WRN= "countries/WRN.txt"
BLG= "countries/BLG.txt"
GLB= "countries/GLB.txt"
WNR= "countries/WNR.txt"
BLW= "countries/BLW.txt"
EGD= "countries/EGD.txt"
MYL= "countries/MYL.txt"
BNM= "countries/BNM.txt"
GUA= "countries/GUA.txt"
ELS= "countries/ELS.txt"
HON= "countries/HON.txt"
NIC= "countries/NIC.txt"
COS= "countries/NIC.txt"
NPL= "countries/NPL.txt"
RTW= "countries/RTW.txt"
PSA= "countries/PSA.txt"
ESG= "countries/ESG.txt"
KOH= "countries/KOH.txt"
SXS= "countries/SXS.txt"
SUE= "countries/SUE.txt"
LBY= "countries/LBY.txt"
DSD= "countries/DSD.txt"
KPD= "countries/KPD.txt"
ITC= "countries/ITC.txt"
BLF= "countries/BLF.txt"
DUQ= "countries/DUQ.txt"
TRO= "countries/TRO.txt"
MOL= "countries/MOL.txt"
GSL= "countries/GSL.txt"
BLS= "countries/BLS.txt"
PHL= "countries/PHL.txt"
PBL= "countries/PBL.txt"
TOR= "countries/TOR.txt"
ASI= "countries/ASI.txt"
JBS= "countries/JBS.txt"
YEM= "countries/YEM.txt"
KWT= "countries/KWT.txt"
KAT= "countries/KAT.txt"
NAF= "countries/NAF.txt"
LSB= "countries/LSB.txt"
FUM= "countries/FUM.txt"
KGL= "countries/KGL.txt"
BXM= "countries/BXM.txt"
KLD= "countries/KLD.txt"
DMT= "countries/DMT.txt"
DAS= "countries/DAS.txt"
SLY= "countries/SLY.txt"
RDN= "countries/RDN.txt"
SNX= "countries/SNX.txt"
TRL= "countries/TRL.txt"
DOR= "countries/DOR.txt"
HEL= "countries/HEL.txt"
XWY= "countries/XWY.txt"
TAJ= "countries/TAJ.txt"
TRT= "countries/TRT.txt"
KOJ= "countries/KOJ.txt"
KOC= "countries/KOC.txt"
MRA= "countries/MRA.txt"
HDL= "countries/HDL.txt"
SXX= "countries/SXX.txt"
MJL= "countries/MJL.txt"
BNT= "countries/BNT.txt"
AGC= "countries/AGC.txt"
DOH= "countries/DOH.txt"
DOS= "countries/DOS.txt"
DOL= "countries/DOL.txt"
DHD= "countries/DHD.txt"
DOF= "countries/DOF.txt"
DOB= "countries/DOB.txt"
DOA= "countries/DOA.txt"
DOM= "countries/DOM.txt"
VCT= "countries/VCT.txt"
MDS= "countries/MDS.txt"
MSE= "countries/MSE.txt"
UKR= "countries/UKR.txt"
UBA= "countries/UBA.txt"
DON= "countries/DON.txt"
DIM= "countries/DIM.txt"
DCK= "countries/DCK.txt"
TPU= "countries/TPU.txt"
AKE= "countries/AKE.txt"
EOB= "countries/EOB.txt"
KKE= "countries/KKE.txt"
KOT= "countries/KOT.txt"
PSG= "countries/PSG.txt"
SSD= "countries/SSD.txt"
LTA= "countries/LTA.txt"
LHA= "countries/LHA.txt"
ETA= "countries/ETA.txt"
LFR= "countries/LFR.txt"
HAZ= "countries/HAZ.txt"
SYR= "countries/SYR.txt"
TKD= "countries/TKD.txt"
HAT= "countries/HAT.txt"
DMA= "countries/DMA.txt"
BFR= "countries/BFR.txt"
HLS= "countries/HLS.txt"
CMA= "countries/CMA.txt"
TSL= "countries/TSL.txt"
XYL= "countries/XYL.txt"
HUN= "countries/HUN.txt"
BRC= "countries/BRC.txt"
BRY= "countries/BRY.txt"
BRG= "countries/BRG.txt"
BRB= "countries/BRB.txt"
LEF= "countries/LEF.txt"
KSR= "countries/KSR.txt"
ROY= "countries/ROY.txt"
PMA= "countries/PMA.txt"
TCY= "countries/TCY.txt"
MIL= "countries/MIL.txt"
SAA= "countries/SAA.txt"
SAB= "countries/SAB.txt"
SAC= "countries/SAC.txt"
SAD= "countries/SAD.txt"
SAE= "countries/SAE.txt"
SAF= "countries/SAF.txt"
SAG= "countries/SAG.txt"
SLO= "countries/SLO.txt"
GRA= "countries/GRA.txt"
ARA= "countries/ARA.txt"
ABA= "countries/ABA.txt"
SML= "countries/SML.txt"
TRA= "countries/TRA.txt"
MEK= "countries/MEK.txt"
MEX= "countries/MEX.txt"
BLR= "countries/BLR.txt"
SPR= "countries/SPR.txt"
BSK= "countries/BSK.txt"
MOA= "countries/MOA.txt"
SHL= "countries/SHL.txt"
HOS= "countries/HOS.txt"
BNA= "countries/BNA.txt"
ICD= "countries/ICD.txt"
QIN= "countries/QIN.txt"
KEI= "countries/KEI.txt"
XUH= "countries/XUH.txt"
XJM= "countries/XJM.txt"
HNZ= "countries/HNZ.txt"
HBR= "countries/HBR.txt"
WSP= "countries/WSP.txt"
MAQ= "countries/MAQ.txt"
ZXN= "countries/ZXN.txt"
NED= "countries/NED.txt"
TGA= "countries/TGA.txt"
GGA= "countries/GGA.txt"
FRD= "countries/FRD.txt"
HLP= "countries/HLP.txt"
JLP= "countries/JLP.txt"
CHI= "countries/CHI.txt"
FPE= "countries/FPE.txt"
BEL = "countries/BEL.txt"
FMS= "countries/FMS.txt"
NTS = "countries/NTS.txt"
CBA = "countries/CBA.txt"
NTB = "countries/NTB.txt"
MSS = "countries/MSS.txt"
TSI = "countries/TSI.txt"
ZAN = "countries/ZAN.txt"
SKM = "countries/SKM.txt"
NFL = "countries/NFL.txt"
BRU = "countries/BRU.txt"
CAC = "countries/CAC.txt"
SZC = "countries/SZC.txt"
ASS = "countries/ASS.txt"
GGZ = "countries/GGZ.txt"
MUH = "countries/MUH.txt"
HOR = "countries/HOR.txt"
AFG = "countries/AFG.txt"
PAR = "countries/PAR.txt"
VFE = "countries/VFE.txt"